en:
  enumeration_names:
    accession_acquisition_type: Accession Acquisition Type
    accession_parts_relator: Accession Parts Relator
    accession_parts_relator_type: Accession Parts Relator Type
    accession_resource_type: Accession Resource Type
    accession_sibling_relator: Accession Sibling Relator
    accession_sibling_relator_type: Accession Sibling Relator Type
    agency_code_type: Record Control Agency Code Type
    agent_contact_salutation: Agent Contact Salutation
    agent_relationship_associative_relator: Agent Relationship Associative Relator
    agent_relationship_earlierlater_relator: Agent Relationship Earlierlater Relator
    agent_relationship_family_relator: Agent Relationship Family Relator
    agent_relationship_hierarchical_relator: Agent Relationship Hierarchical Relator
    agent_relationship_identity_relator: Agent Relationship Identity Relator
    agent_relationship_parentchild_relator: Agent Relationship Parentchild Relator
    agent_relationship_specific_relator: Agent Relationship Specific Relator
    agent_relationship_subordinatesuperior_relator: Agent Relationship Subordinatesuperior
      Relator
    agent_relationship_temporal_relator: Agent Relationship Temporal Relator
    archival_record_level: Archival Record Level
    begin_date_standardized_type: Begin Date Standardized Type
    cataloging_source: Record Control Cataloging Source
    collection_management_processing_priority: Collection Management Processing Priority
    collection_management_processing_status: Collection Management Processing Status
    container_location_status: Container Location Status
    container_type: Container Type
    country_iso_3166: Country ISO 3166
    date_calendar: Date Calendar
    date_certainty: Date Certainty
    date_era: Date Era
    date_label: Date Label
    date_role: Date Role
    date_standardized_type: Date Standardized Type
    date_type: Date Type
    date_type_structured: Date Type
    deaccession_scope: Deaccession Scope
    digital_object_digital_object_type: Digital Object Digital Object Type
    digital_object_level: Digital Object Level
    dimension_units: Dimension Units
    end_date_standardized_type: End Date Standardized Type
    event_event_type: Event Event Type
    event_outcome: Event Outcome
    extent_extent_type: Extent Extent Type
    extent_portion: Extent Portion
    file_version_checksum_methods: File Version Checksum Methods
    file_version_file_format_name: File Version File Format Name
    file_version_use_statement: File Version Use Statement
    file_version_xlink_actuate_attribute: File Version Xlink Actuate Attribute
    file_version_xlink_show_attribute: File Version Xlink Show Attribute
    gender: Agent Gender
    government_agency_type: Record Control Government Agency Type
    identifier_type: Record Control Identifier Type
    instance_instance_type: Instance Instance Type
    job_type: Job Type
    language_iso639_2: Language ISO 639-2
    level_of_detail: Record Control Level of Detail
    linked_agent_archival_record_relators: Linked Agent Archival Record Relators
    linked_agent_event_roles: Linked Agent Event Roles
    linked_agent_role: Linked Agent Role
    linked_event_archival_record_roles: Linked Event Archival Record Roles
    location_function_type: Location Function Type
    location_temporary: Location Temporary
    maintenance_agent_type: Record Control Maintenance Agent Type
    maintenance_event_type: Record Control Maintenance Event Type
    maintenance_status: Record Control Maintenance Status
    metadata_license: Metadata License
    modified_record: Record Control Modified Type
    name_person_name_order: Name Person Name Order
    name_rule: Name Rule
    name_source: Name Source
    name_type: Record Control Name Type
    note_bibliography_type: Note Bibliography Type
    note_digital_object_type: Note Digital Object Type
    note_index_item_type: Note Index Item Type
    note_index_type: Note Index Type
    note_langmaterial_type: Note Language of Materials Type
    note_multipart_type: Note Multipart Type
    note_orderedlist_enumeration: Note Orderedlist Enumeration
    note_rights_statement_act_type: Note Rights Statement Act Type
    note_rights_statement_type: Note Rights Statement Type
    note_singlepart_type: Note Singlepart Type
    place_role: Agent Place Role
    publication_status: Record Control Publication Status
    reference_evaluation: Record Control Reference Evaluation
    resource_finding_aid_description_rules: Resource Finding Aid Description Rules
    resource_finding_aid_status: Resource Finding Aid Status
    resource_resource_type: Resource Resource Type
    restriction_type: Local Access Restriction Type
    rights_statement_act_restriction: Rights Statement Act Restriction
    rights_statement_act_type: Rights Statement Act Type
    rights_statement_external_document_identifier_type: Rights Statement External
      Document Identifier Type
    rights_statement_ip_status: Rights Statement IP Status
    rights_statement_other_rights_basis: Rights Statement Other Rights Basis
    rights_statement_rights_type: Rights Statement Rights Type
    romanization: Romanization
    script_iso15924: Language Script ISO 15924
    subject_source: Subject Source
    subject_term_type: Subject Term Type
    telephone_number_type: Telephone Number Type
    transliteration: Transliteration
    user_defined_enum_1: User Defined Enum 1
    user_defined_enum_2: User Defined Enum 2
    user_defined_enum_3: User Defined Enum 3
    user_defined_enum_4: User Defined Enum 4
  enumerations:
    accession_acquisition_type:
      deposit: Deposit
      gift: Gift
      purchase: Purchase
      transfer: Transfer
      gift_purchase: Gift/Purchase
    accession_parts_relator:
      forms_part_of: Forms Part of
      has_part: Has Part
    accession_parts_relator_type:
      part: '"Part" relationship'
    accession_resource_type:
      collection: Collection
      papers: Papers
      publications: Publications
      records: Records
    accession_sibling_relator:
      sibling_of: Is Sibling of
    accession_sibling_relator_type:
      bound_with: '"Bound With" relationship'
    agency_code_type:
      local: Local
      oclc: OCLC
    agent_contact_salutation:
      madame: Madame
      mr: Mr.
      mrs: Mrs.
      ms: Ms.
      sir: Sir
    agent_relationship_associative_relator:
      is_associative_with: Associative with Related
    agent_relationship_earlierlater_relator:
      is_earlier_form_of: Earlier Form of Related
      is_later_form_of: Later Form of Related
    agent_relationship_family_relator:
      is_related_with: Agent Relationship Related Relator
    agent_relationship_hierarchical_relator:
      is_hierarchical_with: Agent Relationship Hierarchical Relator
    agent_relationship_identity_relator:
      is_identified_with: Agent Relationship Identified With Relator
    agent_relationship_parentchild_relator:
      is_child_of: Child of Related
      is_parent_of: Parent of Related
    agent_relationship_subordinatesuperior_relator:
      is_subordinate_to: Is Subordinate to Related
      is_superior_of: Is Superior of Related
    agent_relationship_temporal_relator:
      is_temporal_with: Agent Relationship Temporal Relator
    archival_record_level:
      class: Class
      collection: Collection
      file: File
      fonds: Fonds
      item: Item
      otherlevel: Other Level
      recordgrp: Record Group
      series: Series
      subfonds: Sub-Fonds
      subgrp: Sub-Group
      subseries: Sub-Series
    begin_date_standardized_type:
      not_after: Not After
      not_before: Not Before
      standard: Standard
    cataloging_source:
      ccp: Cooperative cataloging program
      nat_bib_agency: National bibliographic agency
      natc: No attempt to code
      other: Other
      unknown: Unknown
    collection_management_processing_priority:
      high: High
      low: Low
      medium: Medium
      none: Not specified
    collection_management_processing_status:
      completed: Completed
      in_progress: In Progress
      new: New
      none: Not specified
    container_location_status:
      current: Current
      previous: Previous
    container_type:
      carton: Carton
	  box: Box
	  volume: Volume
	  folder: Folder
      digital_folder: Digital-folder
      oversize_box: Oversize-box
      flat_box: Flat-box
      oversize_folder: Oversize-folder
      oversize_item: Oversize-item
      oversize_portfolio: Oversize-portfolio
	  oversize_volume: Oversize-volume
      item: Item
      tube: Tube
      cardfile_box: Cardfile-box
      pic_box: PIC-box
      ax_box: AX-box
      a_box: A-box
      b_box: B-box
      c_box: C-box
      lan_box: LAN-box
      neg_box: NEG-box
      nneg_box: NNEG-box
      bundle: Bundle
      reel: Reel
	  case: Case
      frame: Frame
      object: Object
      page: Page
	  container: Container
      motion_picture: Motion Picture
      phonotape: Phonotape
      phonodisc: Phonodisc   
	  carton_box: Carton-Box
      carton_folder: Carton-Folder
      box_folder: Box-Folder
      call_number: Call Number
      cassette_box: Cassette-box
      file_box: File-box
      digital_folder: Digital Folder
      envelope: Envelope
      package: Package
      file: File
      folio: Folio
      scrapbook: Scrapbook
      notebook: Notebook
      section: Section
      tape: Tape
      reel_frame: Reel-Frame  
    country_iso_3166:
      AD: Andorra
      AE: United Arab Emirates
      AF: Afghanistan
      AG: Antigua and Barbuda
      AI: Anguilla
      AL: Albania
      AM: Armenia
      AO: Angola
      AQ: Antarctica
      AR: Argentina
      AS: American Samoa
      AT: Austria
      AU: Australia
      AW: Aruba
      AX: Åland Islands
      AZ: Azerbaijan
      BA: Bosnia and Herzegovina
      BB: Barbados
      BD: Bangladesh
      BE: Belgium
      BF: Burkina Faso
      BG: Bulgaria
      BH: Bahrain
      BI: Burundi
      BJ: Benin
      BL: Saint Barthélemy
      BM: Bermuda
      BN: Brunei Darussalam
      BO: Bolivia
      BQ: Bonaire, Sint Eustatius and Saba
      BR: Brazil
      BS: Bahamas
      BT: Bhutan
      BV: Bouvet Island
      BW: Botswana
      BY: Belarus
      BZ: Belize
      CA: Canada
      CC: Cocos (Keeling) Islands
      CD: Democratic Republic of the Congo
      CF: Central African Republic
      CG: Congo
      CH: Switzerland
      CI: Côte d'Ivoire
      CK: Cook Islands
      CL: Chile
      CM: Cameroon
      CN: China
      CO: Colombia
      CR: Costa Rica
      CU: Cuba
      CV: Cape Verde
      CW: Curaçao
      CX: Christmas island
      CY: Cyprus
      CZ: Czech Republic
      DE: Germany
      DJ: Djibouti
      DK: Denmark
      DM: Dominica
      DO: Dominican Republic
      DZ: Algeria
      EC: Ecuador
      EE: Estonia
      EG: Egypt
      EH: Western Sahara
      ER: Eritrea
      ES: Spain
      ET: Ethiopia
      FI: Finland
      FJ: Fiji
      FK: Falkland Islands (Malvinas)
      FM: Micronesia, Federated States of
      FO: Faroe Islands
      FR: France
      GA: Gabon
      GB: United Kingdom
      GD: Grenada
      GE: Georgia
      GF: French Guiana
      GG: Guernsey
      GH: Ghana
      GI: Gibraltar
      GL: Greenland
      GM: Gambia
      GN: Guinea
      GP: Guadeloupe
      GQ: Equatorial Guinea
      GR: Greece
      GS: South Georgia and the South Sandwich Islands
      GT: Guatemala
      GU: Guam
      GW: Guinea-Bissau
      GY: Guyana
      HK: Hong Kong
      HM: Heard Island and Mcdonald Islands
      HN: Honduras
      HR: Croatia
      HT: Haiti
      HU: Hungary
      ID: Indonesia
      IE: Ireland
      IL: Israel
      IM: Isle of Man
      IN: India
      IO: British Indian Ocean Territory
      IQ: Iraq
      IR: Iran, Islamic Republic of
      IS: Iceland
      IT: Italy
      JE: Jersey
      JM: Jamaica
      JO: Jordan
      JP: Japan
      KE: Kenya
      KG: Kyrgyzstan
      KH: Cambodia
      KI: Kiribati
      KM: Comoros
      KN: Saint Kitts and Nevis
      KP: Korea, Democratic People's Republic of
      KR: Korea, Republic of
      KW: Kuwait
      KY: Cayman Islands
      KZ: Kazakhstan
      LA: Lao People's Democratic Republic
      LB: Lebanon
      LC: Saint Lucia
      LI: Liechtenstein
      LK: Sri Lanka
      LR: Liberia
      LS: Lesotho
      LT: Lithuania
      LU: Luxembourg
      LV: Latvia
      LY: Libya
      MA: Morocco
      MC: Monaco
      MD: Moldova, Republic of
      ME: Montenegro
      MF: Saint Martin (French Part)
      MG: Madagascar
      MH: Marshall Islands
      MK: Macedonia, Former Yugoslav Republic of
      ML: Mali
      MM: Myanmar
      MN: Mongolia
      MO: Macao
      MP: Northern Mariana Islands
      MQ: Martinique
      MR: Mauritania
      MS: Montserrat
      MT: Malta
      MU: Mauritius
      MV: Maldives
      MW: Malawi
      MX: Mexico
      MY: Malaysia
      MZ: Mozambique
      NA: Namibia
      NC: New Caledonia
      NE: Niger
      NF: Norfolk Island
      NG: Nigeria
      NI: Nicaragua
      NL: Netherlands
      'NO': Norway
      NP: Nepal
      NR: Nauru
      NU: Niue
      NZ: New Zealand
      OM: Oman
      PA: Panama
      PE: Peru
      PF: French Polynesia
      PG: Papua New Guinea
      PH: Philippines
      PK: Pakistan
      PL: Poland
      PM: Saint Pierre and Miquelon
      PN: Pitcairn
      PR: Puerto rico
      PS: Palestinian Territory, Occupied
      PT: Portugal
      PW: Palau
      PY: Paraguay
      QA: Qatar
      RE: Réunion
      RO: Romania
      RS: Serbia
      RU: Russian Federation
      RW: Rwanda
      SA: Saudi Arabia
      SB: Solomon Islands
      SC: Seychelles
      SD: Sudan
      SE: Sweden
      SG: Singapore
      SH: Saint Helena, Ascension and Tristan da Cunha
      SI: Slovenia
      SJ: Svalbard and Jan Mayen
      SK: Slovakia
      SL: Sierra Leone
      SM: San Marino
      SN: Senegal
      SO: Somalia
      SR: Suriname
      SS: South Sudan
      ST: Sao Tome and Principe
      SV: El Salvador
      SX: Sint Maarten (Dutch Part)
      SY: Syrian Arab Republic
      SZ: Swaziland
      TC: Turks and Caicos Islands
      TD: Chad
      TF: French Southern Territories
      TG: Togo
      TH: Thailand
      TJ: Tajikistan
      TK: Tokelau
      TL: Timor-Leste
      TM: Turkmenistan
      TN: Tunisia
      TO: Tonga
      TR: Turkey
      TT: Trinidad and Tobago
      TV: Tuvalu
      TW: Taiwan, Province of China
      TZ: Tanzania, United Republic of
      UA: Ukraine
      UG: Uganda
      UM: United States Minor Outlying Islands
      US: United States
      UY: Uruguay
      UZ: Uzbekistan
      VA: Holy See (Vatican City State)
      VC: Saint Vincent and the Grenadines
      VE: Venezuela
      VG: Virgin Islands, British
      VI: Virgin Islands, U.S.
      VN: Viet Nam
      VU: Vanuatu
      WF: Wallis and Futuna
      WS: Samoa
      YE: Yemen
      YT: Mayotte
      ZA: South Africa
      ZM: Zambia
      ZW: Zimbabwe
    date_calendar:
      gregorian: Gregorian
    date_certainty:
      approximate: Approximate
      inferred: Inferred
      questionable: Questionable
    date_era:
      ce: ce
    date_label:
      agent_relation: Agent Relation
      broadcast: Broadcast
      copyright: Copyright
      creation: Creation
      deaccession: Deaccession
      digitized: Digitized
      event: Event
      existence: Existence
      issued: Issued
      modified: Modified
      other: Other
      publication: Publication
      record_keeping: Record Keeping
      usage: Usage
    date_role:
      begin: Begin
      end: End
    date_standardized_type:
      not_after: Not After
      not_before: Not Before
      standard: Standard
    date_type:
      bulk: Bulk Dates
      expression: Expression
      inclusive: Inclusive Dates
      range: Range
      single: Single
    date_type_structured:
      range: Range
      single: Single
    deaccession_scope:
      part: Part
      whole: Whole
    digital_object_digital_object_type:
      cartographic: Cartographic
      mixed_materials: Mixed Materials
      moving_image: Moving Image
      notated_music: Notated Music
      software_multimedia: Software, Multimedia
      sound_recording: Sound Recording
      sound_recording_musical: Sound Recording (Musical)
      sound_recording_nonmusical: Sound Recording (Non-musical)
      still_image: Still Image
      text: Text
    digital_object_level:
      collection: Collection
      image: Image
      work: Work
    dimension_units:
      centimeters: Centimeters
      feet: Feet
      inches: Inches
      meters: Meters
      millimeters: Millimeters
      yards: Yards
    end_date_standardized_type:
      not_after: Not After
      not_before: Not Before
      standard: Standard
    event_event_type:
      access_request: Access Request
      access: Access
      accession: Accession
      accessioned: Accessioned
      accumulation: Accumulation
      acknowledgement: Acknowledgement
      acknowledgement_sent: Acknowledgement Sent
      acknowledgement_received: Acknowledgement Received
      agreement: Agreement
      agreement_received: Agreement Received
      agreement_sent: Agreement Sent
      agreement_signed: Agreement Signed
	  appraisal_archival: Appraisal-Archival
      appraisal_monetary: Appraisal-Monetary
      assigned: Assigned
      assessment: Assessment
      assessment_noi: Assessment-NOI	  
      authority_work: Authority Work
      capture: Capture
      cataloged: Cataloged
      collection: Collection
      compression: Compression
      contribution: Contribution
      component_destruction: Component Destruction
      component_transfer: Component Transfer
      copyright_transfer: Copyright Transfer
      custody_transfer: Custody Transfer
      deaccession: Deaccession
      deaccession_nrlf: Deaccession-NRLF	  
      decompression: Decompression
      decryption: Decryption
      deferred_cataloging: Deferred Cataloging
      deferred_finding_aid: Deferred Finding Aid
      deferred_housing: Deferred Housing
      deferred_reformatting: Deferred Reformatting
      deferred_processing: Deferred Processing
      deletion: Deletion
      digital_objects_added: Digital Objects Added
      digital_signature_validation: Digital Signature Validation
      disk_imaged: Disk Imaged
      fixity_check: Fixity Check
      funded_processing: Funded-Processing	  
      ingestion: Ingestion
      maintenance_arrangement: Maintenance Arrangement	  
      maintenance_finding_aid: Maintenance Finding Aid
      maintenance_catalog_record: Maintenance Catalog Record
      maintenance_housing: Maintenance Housing
      materials_routed: Materials Routed
      materials_transferred: Materials Transferred
      message_digest_calculation: Message Digest Calculation
      migration: Migration
      normalization: Normalization
      pii_review: PII Review	  
      preservation_frozen: Preservation-Frozen
      preservation_sent_cons: Preservation-Sent to Cons
      preservation_returned_cons: Preservation-Returned from Cons
      processed: Processed
      processing_new: Processing New
      processing_started: Processing Started
      processing_in_progress: Processing in Progress
      processing_completed: Processing Completed
      processing_Completed: Processing_Completed
      publication: Publication
      publication_findingaid: Publication-Finding Aid
      purchased: Purchased	  
	  republication_findingaid: Republication-Finding Aid
      reference_request: Reference Request
      replication: Replication
      request: Request
      rights_transferred: Rights Transferred
      separation: Separation	  
      shelved: Shelved	  
      student_process: Student Process	  
      triaged: Triaged
      validation: Validation
      virus_check: Virus Check
    event_outcome:
      cancelled: Cancelled
      fail: Fail
      fulfilled: Fulfilled
      partial pass: Partial Pass
      pass: Pass
      pending: Pending
      completed_Level1: Completed-Level 1
      completed_Level2: Completed-Level 2
      completed_Level3: Completed-Level 3
      completed_Level4: Completed-Level 4
      completed_Level5: Completed-Level 5
      completed_Level6: Completed-Level 6
      partial: Partial
      queued: Queued
      returned: Returned
      started: Started
      uncataloged: Uncataloged
      unsuccessful: Unsuccessful
      in_process: In Process
      opened: Opened
      closed: Closed
      full: Full
      false: false
      true: true
    extent_extent_type:
      linear_feet: linear feet
      binder: binder
      binders: binders
      bundle: bundle
      bundles: bundles
      diskette: diskette
      diskettes: diskettes
      drawing: drawing
      drawings: drawings
      exposures: exposures
      files: files
      film_cartridge: film cartridge
      film_cartridges: film cartridges
      film_cassette: film cassette
      film_cassettes: film cassettes
      film_loop: film loop
      film_loops: film loops
      film_reel: film reel
      film_reels: film reels
      gigabytes: GB
      hard_drive: hard drive
      hard_drives: hard drives
      item: item
      items: items
      magnetic_data_tape: magnetic data tape
      magnetic_data_tapes: magnetic data tapes
      megabytes: MB
      microfilm_reel: microfilm reel
      microfilm_reels: microfilm reels
      notebook: notebook
      notebooks: notebooks
      optical_disc: optical disc
      optical_discs: optical discs
      painting: painting
      paintings: paintings
      photograph: photograph
      photograph: photograph
      photographs: photographs
      photographs: photographs
      picture: picture
      pictures: pictures
      portfolio: portfolio
      portfolios: portfolios
      print: print
      prints: prints
      sheets: sheets
      sound_cartridge: sound cartridge
      sound_cartridges: sound cartridges	  
      sound_cartridge_8_track: sound cartridge (8 track)
      sound_cartridges_8_track: sound cartridges (8 track)
      sound_cartridge_Fidelipac: sound cartridge (Fidelipac)
      sound_cartridges_Fidelipac: sound cartridges (Fidelipac)
      sound_cassette: sound cassette
      sound_cassettes: sound cassettes
      sound_cassette_DAT: sound cassette (DAT)
      sound_cassettes_DAT: sound cassettes (DAT)
      sound_cassette_microcassette: sound cassette (microcassette)
      sound_cassettes_microcassette: sound cassettes (microcassette)
      sound_cylinder: sound cylinder
      sound_cylinders: sound cylinders
      sound_disc: sound disc
      sound_discs: sound discs
      sound_disc_CD: sound disc (CD)
      sound_discs_CD: sound discs (CD)
      sound_disc_Minidisc: sound disc (Minidisc)
      sound_discs_Minidisc: sound discs (Minidisc)
      sound_disc_aluminum: sound disc (aluminum)
      sound_discs_aluminum: sound discs (aluminum)
      sound_disc_lacquer: sound disc (lacquer)
      sound_discs_lacquer: sound discs (lacquer)
      sound_disc_vinyl: sound disc (vinyl)
      sound_discs_vinyl: sound discs (vinyl)
	  sound_recording: sound recording
      sound_recordings: sound recordings
      sound_tape_reel: sound tape reel
      sound_tape_reels: sound tape reels
      sound_tape_reel_NAGRA_SN: sound tape reel (NAGRA SN)
      sound_tape_reels_NAGRA_SN: sound tape reels (NAGRA SN)
      sound_track_film_reel: sound track film reel
      sound_track_film_reels: sound track film reels
      sound_wire_reel: sound wire reel
      sound_wire_reels: sound wire reels
      terabytes: TB
      video_recording: video recording
      video_recordings: video recordings
      videocartridge: videocartridge
      videocartridges: videocartridges
      videocassette: videocassette
      videocassettes: videocassettes
      videocassette_Betacam: videocassette (Betacam)
	  videocassettes_Betacam: videocassettes (Betacam)
      videocassette_BetacamSP: videocassette (BetacamSP)
      videocassettes_BetacamSP: videocassettes (BetacamSP)	  
      videocassette_Betamax: videocassette (Betamax)
      videocassettes_Betamax: videocassettes (Betamax)	  
      videocassette_DVCAM: videocassette (DVCAM)
      videocassettes_DVCAM: videocassettes (DVCAM)	  
      videocassette_DVCPro: videocassette (DVCPro)
      videocassettes_DVCPro: videocassettes (DVCPro)	  
      videocassette_D_1: videocassette (D-1)
      videocassettes_D_1: videocassettes (D-1)	  
      videocassette_D_2: videocassette (D-2)
      videocassettes_D_2: videocassettes (D-2)	  
      videocassette_Digital_Betacam: videocassette (Digital Betacam)
      videocassettes_Digital_Betacam: videocassettes (Digital Betacam)	  
      videocassette_HDCAM: videocassette (HDCAM)
      videocassettes_HDCAM: videocassettes (HDCAM)	  
      videocassette_Hi8: videocassette (Hi8)
      videocassettes_Hi8: videocassettes (Hi8)	  
      videocassette_MiniDV: videocassette (MiniDV)
      videocassettes_MiniDV: videocassettes (MiniDV)	  
      videocassette_S_VHS: videocassette (S-VHS)
      videocassettes_S_VHS: videocassettes (S-VHS)	  
      videocassette_U_matic: videocassette (U-matic)
      videocassettes_U_matic: videocassettes (U-matic)	  
      videocassette_VHS: videocassette (VHS)
      videocassettes_VHS: videocassettes (VHS)	  
      videocassette_VHS_C: videocassette (VHS-C)
      videocassettes_VHS_C: videocassettes (VHS-C)	  
      videocassette_Video_8: videocassette (Video 8)
      videocassettes_Video_8: videocassettes (Video 8)
      videodisc: videodisc
      videodiscs: videodiscs	  
      videodisc_Blue_Ray: videodisc (Blue Ray)
      videodiscs_Blue_Ray: videodiscs (Blue Ray)	  
      videodisc_DVD: videodisc (DVD)
      videodiscs_DVD: videodiscs (DVD)	  
      videodisc_laser: videodisc (laser)
      videodiscs_laser: videodiscs (laser)	  
      videoreel_1_inch: videoreel (1 inch)
      videoreels_1_inch: videoreels (1 inch)	  
      videoreel_2_inch: videoreel (2 inch)
      videoreels_2_inch: videoreels (2 inch)	  
      videoreel_half_inch: videoreel (1/2 inch)
      videoreels_half_inch: videoreels (1/2 inch)	  
      videotape: videotape
      videotapes: videotapes
	  volume: volume
      volumes: volumes
    extent_portion:
      part: Part
      whole: Whole
    file_version_checksum_methods:
      md5: MD5
      sha-1: SHA-1
      sha-256: SHA-256
      sha-384: SHA-384
      sha-512: SHA-512
    file_version_file_format_name:
      aiff: Audio Interchange File Format
      avi: Audio/Video Interleaved Format
      gif: Graphics Interchange Format
      jpeg: JPEG File Interchange Format
      mp3: MPEG Audio Layer 3
      pdf: Portable Document Format
      tiff: Tagged Image File Format
      txt: Plain Text File
      mp4: MPEG-4, Part 14
    file_version_use_statement:
      audio-clip: Audio-Clip
      audio-master: Audio-Master
      audio-master-edited: Audio-Master-Edited
      audio-service: Audio-Service
      audio-streaming: Audio-Streaming
      image-master: Image-Master
      image-master-edited: Image-Master-Edited
      image-service: Image-Service
      image-service-edited: Image-Service-Edited
      image-thumbnail: Image-Thumbnail
      text-codebook: Text-Codebook
      text-data: Text-Data
      text-data_definition: Text-Data Definition
      text-georeference: Text-Georeference
      text-ocr-edited: Text-Ocr-Edited
      text-ocr-unedited: Text-Ocr-Unedited
      text-tei-transcripted: Text-Tei-Transcripted
      text-tei-translated: Text-Tei-Translated
      video-clip: Video-Clip
      video-master: Video-Master
      video-master-edited: Video-Master-Edited
      video-service: Video-Service
      video-streaming: Video-Streaming
    file_version_xlink_actuate_attribute:
      none: none
      onLoad: onLoad
      onRequest: onRequest
      other: other
    file_version_xlink_show_attribute:
      embed: embed
      new: new
      none: none
      other: other
      replace: replace
    gender:
      not_specified: Not Specified
    government_agency_type:
      fed: Federal/national
      int_gov: International intergovernmental
      local: Local
      multilocal: Multilocal
      multistate: Multistate
      natc: No attempt to code
      ngo: Non-governmental organization
      other: Other
      provincial: State, provincial, territorial, dependent, etc.
      sac: Autonomous or semi-autonomous component
      undetermined: Government agency-type undetermined
      unknown: Unknown if heading is government agency
    identifier_type:
      lac: Library and Archives Canada
      loc: Library of Congress
      local: Local
    instance_instance_type:
      accession: Accession
      audio: Audio
      books: Books
      computer_disks: Computer Disks
      digital_object: Digital Object
      digital_object_link: Digital Object Link
      graphic_materials: Graphic Materials
      maps: Maps
      microform: Microform
      mixed_materials: Mixed Materials
      moving_images: Moving Images
      realia: Realia
      text: Text
    language_iso639_2:
      aar: Afar
      abk: Abkhazian
      ace: Achinese
      ach: Acoli
      ada: Adangme
      ady: Adyghe; Adygei
      afa: Afro-Asiatic languages
      afh: Afrihili
      afr: Afrikaans
      ain: Ainu
      aka: Akan
      akk: Akkadian
      alb: Albanian
      ale: Aleut
      alg: Algonquian languages
      alt: Southern Altai
      amh: Amharic
      ang: English, Old (ca.450-1100)
      anp: Angika
      apa: Apache languages
      ara: Arabic
      arc: Official Aramaic (700-300 BCE); Imperial Aramaic (700-300 BCE)
      arg: Aragonese
      arm: Armenian
      arn: Mapudungun; Mapuche
      arp: Arapaho
      art: Artificial languages
      arw: Arawak
      asm: Assamese
      ast: Asturian; Bable; Leonese; Asturleonese
      ath: Athapascan languages
      aus: Australian languages
      ava: Avaric
      ave: Avestan
      awa: Awadhi
      aym: Aymara
      aze: Azerbaijani
      bad: Banda languages
      bai: Bamileke languages
      bak: Bashkir
      bal: Baluchi
      bam: Bambara
      ban: Balinese
      baq: Basque
      bas: Basa
      bat: Baltic languages
      bej: Beja; Bedawiyet
      bel: Belarusian
      bem: Bemba
      ben: Bengali
      ber: Berber languages
      bho: Bhojpuri
      bih: Bihari languages
      bik: Bikol
      bin: Bini; Edo
      bis: Bislama
      bla: Siksika
      bnt: Bantu (Other)
      bos: Bosnian
      bra: Braj
      bre: Breton
      btk: Batak languages
      bua: Buriat
      bug: Buginese
      bul: Bulgarian
      bur: Burmese
      byn: Blin; Bilin
      cad: Caddo
      cai: Central American Indian languages
      car: Galibi Carib
      cat: Catalan; Valencian
      cau: Caucasian languages
      ceb: Cebuano
      cel: Celtic languages
      cha: Chamorro
      chb: Chibcha
      che: Chechen
      chg: Chagatai
      chi: Chinese
      chk: Chuukese
      chm: Mari
      chn: Chinook jargon
      cho: Choctaw
      chp: Chipewyan; Dene Suline
      chr: Cherokee
      chu: Church Slavic; Old Slavonic; Church Slavonic; Old Bulgarian; Old Church
        Slavonic
      chv: Chuvash
      chy: Cheyenne
      cmc: Chamic languages
      cnr: Montenegrin
      cop: Coptic
      cor: Cornish
      cos: Corsican
      cpe: Creoles and pidgins, English-based
      cpf: Creoles and pidgins, French-based
      cpp: Creoles and pidgins, Portuguese-based
      cre: Cree
      crh: Crimean Tatar; Crimean Turkish
      crp: Creoles and pidgins
      csb: Kashubian
      cus: Cushitic languages
      cze: Czech
      dak: Dakota
      dan: Danish
      dar: Dargwa
      day: Land Dayak languages
      del: Delaware
      den: Slave (Athapascan)
      dgr: Dogrib
      din: Dinka
      div: Divehi; Dhivehi; Maldivian
      doi: Dogri
      dra: Dravidian languages
      dsb: Lower Sorbian
      dua: Duala
      dum: Dutch, Middle (ca.1050-1350)
      dut: Dutch; Flemish
      dyu: Dyula
      dzo: Dzongkha
      efi: Efik
      egy: Egyptian (Ancient)
      eka: Ekajuk
      elx: Elamite
      eng: English
      enm: English, Middle (1100-1500)
      epo: Esperanto
      est: Estonian
      ewe: Ewe
      ewo: Ewondo
      fan: Fang
      fao: Faroese
      fat: Fanti
      fij: Fijian
      fil: Filipino; Pilipino
      fin: Finnish
      fiu: Finno-Ugrian languages
      fon: Fon
      fre: French
      frm: French, Middle (ca.1400-1600)
      fro: French, Old (842-ca.1400)
      frr: Northern Frisian
      frs: Eastern Frisian
      fry: Western Frisian
      ful: Fulah
      fur: Friulian
      gaa: Ga
      gay: Gayo
      gba: Gbaya
      gem: Germanic languages
      geo: Georgian
      ger: German
      gez: Geez
      gil: Gilbertese
      gla: Gaelic; Scottish Gaelic
      gle: Irish
      glg: Galician
      glv: Manx
      gmh: German, Middle High (ca.1050-1500)
      goh: German, Old High (ca.750-1050)
      gon: Gondi
      gor: Gorontalo
      got: Gothic
      grb: Grebo
      grc: Greek, Ancient (to 1453)
      gre: Greek, Modern (1453-)
      grn: Guarani
      gsw: Swiss German; Alemannic; Alsatian
      guj: Gujarati
      gwi: Gwich'in
      hai: Haida
      hat: Haitian; Haitian Creole
      hau: Hausa
      haw: Hawaiian
      heb: Hebrew
      her: Herero
      hil: Hiligaynon
      him: Himachali languages; Western Pahari languages
      hin: Hindi
      hit: Hittite
      hmn: Hmong; Mong
      hmo: Hiri Motu
      hrv: Croatian
      hsb: Upper Sorbian
      hun: Hungarian
      hup: Hupa
      iba: Iban
      ibo: Igbo
      ice: Icelandic
      ido: Ido
      iii: Sichuan Yi; Nuosu
      ijo: Ijo languages
      iku: Inuktitut
      ile: Interlingue; Occidental
      ilo: Iloko
      ina: Interlingua (International Auxiliary Language Association)
      inc: Indic languages
      ind: Indonesian
      ine: Indo-European languages
      inh: Ingush
      ipk: Inupiaq
      ira: Iranian languages
      iro: Iroquoian languages
      ita: Italian
      jav: Javanese
      jbo: Lojban
      jpn: Japanese
      jpr: Judeo-Persian
      jrb: Judeo-Arabic
      kaa: Kara-Kalpak
      kab: Kabyle
      kac: Kachin; Jingpho
      kal: Kalaallisut; Greenlandic
      kam: Kamba
      kan: Kannada
      kar: Karen languages
      kas: Kashmiri
      kau: Kanuri
      kaw: Kawi
      kaz: Kazakh
      kbd: Kabardian
      kha: Khasi
      khi: Khoisan languages
      khm: Central Khmer
      kho: Khotanese; Sakan
      kik: Kikuyu; Gikuyu
      kin: Kinyarwanda
      kir: Kirghiz; Kyrgyz
      kmb: Kimbundu
      kok: Konkani
      kom: Komi
      kon: Kongo
      kor: Korean
      kos: Kosraean
      kpe: Kpelle
      krc: Karachay-Balkar
      krl: Karelian
      kro: Kru languages
      kru: Kurukh
      kua: Kuanyama; Kwanyama
      kum: Kumyk
      kur: Kurdish
      kut: Kutenai
      lad: Ladino
      lah: Lahnda
      lam: Lamba
      lao: Lao
      lat: Latin
      lav: Latvian
      lez: Lezghian
      lim: Limburgan; Limburger; Limburgish
      lin: Lingala
      lit: Lithuanian
      lol: Mongo
      loz: Lozi
      ltz: Luxembourgish; Letzeburgesch
      lua: Luba-Lulua
      lub: Luba-Katanga
      lug: Ganda
      lui: Luiseno
      lun: Lunda
      luo: Luo (Kenya and Tanzania)
      lus: Lushai
      mac: Macedonian
      mad: Madurese
      mag: Magahi
      mah: Marshallese
      mai: Maithili
      mak: Makasar
      mal: Malayalam
      man: Mandingo
      mao: Maori
      map: Austronesian languages
      mar: Marathi
      mas: Masai
      may: Malay
      mdf: Moksha
      mdr: Mandar
      men: Mende
      mga: Irish, Middle (900-1200)
      mic: Mi'kmaq; Micmac
      min: Minangkabau
      mis: Uncoded languages
      mkh: Mon-Khmer languages
      mlg: Malagasy
      mlt: Maltese
      mnc: Manchu
      mni: Manipuri
      mno: Manobo languages
      moh: Mohawk
      mon: Mongolian
      mos: Mossi
      mul: Multiple languages
      mun: Munda languages
      mus: Creek
      mwl: Mirandese
      mwr: Marwari
      myn: Mayan languages
      myv: Erzya
      nah: Nahuatl languages
      nai: North American Indian languages
      nap: Neapolitan
      nau: Nauru
      nav: Navajo; Navaho
      nbl: Ndebele, South; South Ndebele
      nde: Ndebele, North; North Ndebele
      ndo: Ndonga
      nds: Low German; Low Saxon; German, Low; Saxon, Low
      nep: Nepali
      new: Nepal Bhasa; Newari
      nia: Nias
      nic: Niger-Kordofanian languages
      niu: Niuean
      nno: Norwegian Nynorsk; Nynorsk, Norwegian
      nob: Norwegian Bokmål; Bokmål, Norwegian
      nog: Nogai
      non: Norse, Old
      nor: Norwegian
      nqo: N'Ko
      nso: Pedi; Sepedi; Northern Sotho
      nub: Nubian languages
      nwc: Classical Newari; Old Newari; Classical Nepal Bhasa
      nya: Chichewa; Chewa; Nyanja
      nym: Nyamwezi
      nyn: Nyankole
      nyo: Nyoro
      nzi: Nzima
      oci: Occitan (post 1500); Provençal
      oji: Ojibwa
      ori: Oriya
      orm: Oromo
      osa: Osage
      oss: Ossetian; Ossetic
      ota: Turkish, Ottoman (1500-1928)
      oto: Otomian languages
      paa: Papuan languages
      pag: Pangasinan
      pal: Pahlavi
      pam: Pampanga; Kapampangan
      pan: Panjabi; Punjabi
      pap: Papiamento
      pau: Palauan
      peo: Persian, Old (ca.600-400 B.C.)
      per: Persian
      phi: Philippine languages
      phn: Phoenician
      pli: Pali
      pol: Polish
      pon: Pohnpeian
      por: Portuguese
      pra: Prakrit languages
      pro: Provençal, Old (to 1500)
      pus: Pushto; Pashto
      que: Quechua
      raj: Rajasthani
      rap: Rapanui
      rar: Rarotongan; Cook Islands Maori
      roa: Romance languages
      roh: Romansh
      rom: Romany
      rum: Romanian; Moldavian; Moldovan
      run: Rundi
      rup: Aromanian; Arumanian; Macedo-Romanian
      rus: Russian
      sad: Sandawe
      sag: Sango
      sah: Yakut
      sai: South American Indian (Other)
      sal: Salishan languages
      sam: Samaritan Aramaic
      san: Sanskrit
      sas: Sasak
      sat: Santali
      scn: Sicilian
      sco: Scots
      sel: Selkup
      sem: Semitic languages
      sga: Irish, Old (to 900)
      sgn: Sign Languages
      shn: Shan
      sid: Sidamo
      sin: Sinhala; Sinhalese
      sio: Siouan languages
      sit: Sino-Tibetan languages
      sla: Slavic languages
      slo: Slovak
      slv: Slovenian
      sma: Southern Sami
      sme: Northern Sami
      smi: Sami languages
      smj: Lule Sami
      smn: Inari Sami
      smo: Samoan
      sms: Skolt Sami
      sna: Shona
      snd: Sindhi
      snk: Soninke
      sog: Sogdian
      som: Somali
      son: Songhai languages
      sot: Sotho, Southern
      spa: Spanish; Castilian
      srd: Sardinian
      srn: Sranan Tongo
      srp: Serbian
      srr: Serer
      ssa: Nilo-Saharan languages
      ssw: Swati
      suk: Sukuma
      sun: Sundanese
      sus: Susu
      sux: Sumerian
      swa: Swahili
      swe: Swedish
      syc: Classical Syriac
      syr: Syriac
      tah: Tahitian
      tai: Tai languages
      tam: Tamil
      tat: Tatar
      tel: Telugu
      tem: Timne
      ter: Tereno
      tet: Tetum
      tgk: Tajik
      tgl: Tagalog
      tha: Thai
      tib: Tibetan
      tig: Tigre
      tir: Tigrinya
      tiv: Tiv
      tkl: Tokelau
      tlh: Klingon; tlhIngan-Hol
      tli: Tlingit
      tmh: Tamashek
      tog: Tonga (Nyasa)
      ton: Tonga (Tonga Islands)
      tpi: Tok Pisin
      tsi: Tsimshian
      tsn: Tswana
      tso: Tsonga
      tuk: Turkmen
      tum: Tumbuka
      tup: Tupi languages
      tur: Turkish
      tut: Altaic languages
      tvl: Tuvalu
      twi: Twi
      tyv: Tuvinian
      udm: Udmurt
      uga: Ugaritic
      uig: Uighur; Uyghur
      ukr: Ukrainian
      umb: Umbundu
      und: Undetermined
      urd: Urdu
      uzb: Uzbek
      vai: Vai
      ven: Venda
      vie: Vietnamese
      vol: Volapük
      vot: Votic
      wak: Wakashan languages
      wal: Walamo
      war: Waray
      was: Washo
      wel: Welsh
      wen: Sorbian languages
      wln: Walloon
      wol: Wolof
      xal: Kalmyk; Oirat
      xho: Xhosa
      yao: Yao
      yap: Yapese
      yid: Yiddish
      yor: Yoruba
      ypk: Yupik languages
      zap: Zapotec
      zbl: Blissymbols; Blissymbolics; Bliss
      zen: Zenaga
      zgh: Standard Moroccan Tamazight
      zha: Zhuang; Chuang
      znd: Zande languages
      zul: Zulu
      zun: Zuni
      zxx: No linguistic content; Not applicable
      zza: Zaza; Dimili; Dimli; Kirdki; Kirmanjki; Zazaki
    level_of_detail:
      fully_established: Fully established
      memorandum: Memorandum
      natc: No attempt to code
      not_applicable: Not applicable
      preliminary: Preliminary
      provisional: Provisional
    linked_agent_archival_record_relators:
      abr: Abridger
      acp: Art copyist
      act: Actor
      adi: Art director
      adp: Adapter
      aft: Author of afterword, colophon, etc.
      anl: Analyst
      anm: Animator
      ann: Annotator
      ant: Bibliographic antecedent
      ape: Appellee
      apl: Appellant
      app: Applicant
      aqt: Author in quotations or text abstracts
      arc: Architect
      ard: Artistic director
      arr: Arranger
      art: Artist
      asg: Assignee
      asn: Associated name
      ato: Autographer
      att: Attributed name
      auc: Auctioneer
      aud: Author of dialog
      aui: Author of introduction, etc.
      aus: Author of screenplay, etc.
      aut: Author
      bdd: Binding designer
      bjd: Bookjacket designer
      bkd: Book designer
      bkp: Book producer
      blw: Blurb writer
      bnd: Binder
      bpd: Bookplate designer
      brd: Broadcaster
      brl: Braille embosser
      bsl: Bookseller
      cas: Caster
      ccp: Conceptor
      chr: Choreographer
      clb: Collaborator
      cli: Client
      cll: Calligrapher
      clr: Colorist
      clt: Collotyper
      cmm: Commentator
      cmp: Composer
      cmt: Compositor
      cnd: Conductor
      cng: Cinematographer
      cns: Censor
      coe: Contestant-appellee
      col: Collector
      com: Compiler
      con: Conservator
      cor: Collection registrar
      cos: Contestant
      cot: Contestant-appellant
      cou: Court governed
      cov: Cover designer
      cpc: Copyright claimant
      cpe: Complainant-appellee
      cph: Copyright holder
      cpl: Complainant
      cpt: Complainant-appellant
      cre: Creator
      crp: Correspondent
      crr: Corrector
      crt: Court reporter
      csl: Consultant
      csp: Consultant to a project
      cst: Costume designer
      ctb: Contributor
      cte: Contestee-appellee
      ctg: Cartographer
      ctr: Contractor
      cts: Contestee
      ctt: Contestee-appellant
      cur: Curator of an exhibition
      cwt: Commentator for written text
      dbp: Distribution place
      dfd: Defendant
      dfe: Defendant-appellee
      dft: Defendant-appellant
      dgg: Degree grantor
      dgs: Degree supervisor
      dis: Dissertant
      dln: Delineator
      dnc: Dancer
      dnr: Donor
      dpc: Depicted
      dpt: Depositor
      drm: Draftsman
      drt: Director
      dsr: Designer
      dst: Distributor
      dtc: Data contributor
      dte: Dedicatee
      dtm: Data manager
      dto: Dedicator
      dub: Dubious author
      edc: Editor of compilation
      edm: Editor of moving image work
      edt: Editor
      egr: Engraver
      elg: Electrician
      elt: Electrotyper
      eng: Engineer
      enj: Enacting jurisdiction
      etr: Etcher
      evp: Event place
      exp: Appraiser
      fac: Facsimilist
      fds: Film distributor
      fld: Field director
      flm: Film editor
      fmd: Film director
      fmk: Filmmaker
      fmo: Former owner
      fmp: Film producer
      fnd: Funder
      fpy: First party
      frg: Forger
      gis: Geographic information specialist
      grt: Graphic technician
      his: Host institution
      hnr: Honoree
      hst: Host
      ill: Illustrator
      ilu: Illuminator
      ins: Inscriber
      inv: Inventor
      isb: Issuing body
      itr: Instrumentalist
      ive: Interviewee
      ivr: Interviewer
      jud: Judge
      jug: Jurisdiction governed
      lbr: Laboratory
      lbt: Librettist
      ldr: Laboratory director
      led: Lead
      lee: Libelee-appellee
      lel: Libelee
      len: Lender
      let: Libelee-appellant
      lgd: Lighting designer
      lie: Libelant-appellee
      lil: Libelant
      lit: Libelant-appellant
      lsa: Landscape architect
      lse: Licensee
      lso: Licensor
      ltg: Lithographer
      lyr: Lyricist
      mcp: Music copyist
      mdc: Metadata contact
      med: Medium
      mfp: Manufacture place
      mfr: Manufacturer
      mod: Moderator
      mon: Monitor
      mrb: Marbler
      mrk: Markup editor
      msd: Musical director
      mte: Metal-engraver
      mtk: Minute taker
      mus: Musician
      nrt: Narrator
      opn: Opponent
      org: Originator
      orm: Organizer of meeting
      osp: Onscreen presenter
      oth: Other
      own: Owner
      pan: Panelist
      pat: Patron
      pbd: Publishing director
      pbl: Publisher
      pdr: Project director
      pfr: Proofreader
      pht: Photographer
      plt: Platemaker
      pma: Permitting agency
      pmn: Production manager
      pop: Printer of plates
      ppm: Papermaker
      ppt: Puppeteer
      pra: Praeses
      prc: Process contact
      prd: Production personnel
      pre: Presenter
      prf: Performer
      prg: Programmer
      prm: Printmaker
      prn: Production company
      pro: Producer
      prp: Production place
      prs: Production designer
      prt: Printer
      prv: Provider
      pta: Patent applicant
      pte: Plaintiff-appellee
      ptf: Plaintiff
      pth: Patentee
      ptt: Plaintiff-appellant
      pup: Publication place
      rbr: Rubricator
      rcd: Recordist
      rce: Recording engineer
      rcp: Recipient
      rdd: Radio director
      red: Redaktor
      ren: Renderer
      res: Researcher
      rev: Reviewer
      rpc: Radio producer
      rps: Repository
      rpt: Reporter
      rpy: Responsible party
      rse: Respondent-appellee
      rsg: Restager
      rsp: Respondent
      rsr: Restorationist
      rst: Respondent-appellant
      rth: Research team head
      rtm: Research team member
      sad: Scientific advisor
      sce: Scenarist
      scl: Sculptor
      scr: Scribe
      sds: Sound designer
      sec: Secretary
      sgd: Stage director
      sgn: Signer
      sht: Supporting host
      sll: Seller
      sng: Singer
      spk: Speaker
      spn: Sponsor
      spy: Second party
      srv: Surveyor
      std: Set designer
      stg: Setting
      stl: Storyteller
      stm: Stage manager
      stn: Standards body
      str: Stereotyper
      tcd: Technical director
      tch: Teacher
      ths: Thesis advisor
      tld: Television director
      tlp: Television producer
      trc: Transcriber
      trl: Translator
      tyd: Type designer
      tyg: Typographer
      uvp: University place
      vac: Voice actor
      vdg: Videographer
      voc: Vocalist
      wac: Writer of added commentary
      wal: Writer of added lyrics
      wam: Writer of accompanying material
      wat: Writer of added text
      wdc: Woodcutter
      wde: Wood engraver
      win: Writer of introduction
      wit: Witness
      wpr: Writer of preface
      wst: Writer of supplementary textual content
      int: Intermediary
    linked_agent_event_roles:
      authorizer: Authorizer
      executing_program: Executing Program
      implementer: Implementer
      recipient: Recipient
      requester: Requester
      transmitter: Transmitter
      validator: Validator
      accessioner: Accessioner
      appraiser: Appraiser
      curator: Curator
      funding_source: Funding Source
      processor: Processor
      reviewer: Reviewer
      seller: Seller
      staff: Staff
      uc_rep: UC Rep
      vendor: Vendor
    linked_agent_role:
      creator: Creator
      source: Source
      subject: Subject
    linked_event_archival_record_roles:
      context: Context
      outcome: Outcome
      requested: Requested
      source: Source
      transfer: Transfer
    location_function_type:
      arrivals: Arrivals
      av_materials: Audiovisual Materials
      shared: Shared
    location_temporary:
      conservation: Conservation
      exhibit: Exhibit
      loan: Loan
      reading_room: Reading Room
    maintenance_agent_type:
      human: Human
      machine: Machine
    maintenance_event_type:
      cancelled: Cancelled
      created: Created
      deleted: Deleted
      derived: Derived
      revised: Revised
      updated: Updated
    maintenance_status:
      cancelled_obsolete: Cancelled/Obsolete
      deleted: Deleted
      deleted_replaced: Deleted-Replaced
      deleted_merged: Deleted-Merged
      deleted_split: Deleted-Split
      derived: Derived
      new: New
      revised_corrected: Revised/Corrected
      upgraded: Upgraded
    metadata_license:
      no_derivatives: This record is made available under an Attribution-NoDerivatives
        4.0 International Creative Commons license.
      non_commercial: This record is made available under an Attribution-NonCommercial
        4.0 International Creative Commons license.
      non_commercial_no_derivatives: This record is made available under an Attribution-NonCommercial-NoDerivatives
        4.0 International Creative Commons license.
      non_commercial_share_a_like: This record is made available under an Attribution-NonCommercial-ShareAlike
        4.0 International Creative Commons license.
      other: Unspecified or custom license.
      public_domain: This record is made available under an Universal 1.0 Public Domain
        Dedication Creative Commons license.
      share_a_like: This record is made available under an Attribution-ShareAlike
        4.0 International Creative Commons license.
    modified_record:
      missing_characters: Missing characters
      natc: No attempt to code
      not_modified: Not modified
      shortened: Shortened
    name_person_name_order:
      direct: Direct
      inverted: Indirect
    name_rule:
      aacr: AACR
      ccr: Cataloging Cultural Resources
      dacs: DACS
      isaar: International Standard Archival Authority Record for Corporate Bodies,
        Persons, and Families
      local: Local rules
      rad: Rules for Archival Description
      rda: RDA
      dcrm_mss: DCRM(MSS)
    name_source:
      cash: CASH
      ingest: Unspecified ingested source
      lcnaf: LCNAF
      lcshac: LCSHAC
      local: Local sources
      nad: NAD/ARK II
      naf: NACO Authority File
      nal: NAL
      ram: RAM
      rvm: RVM
      snac: SNAC
      ulan: ULAN
      viaf: VIAF
    name_type:
      differentiated: Differentiated
      natc: No attempt to code
      not_applicable: Not applicable
      undifferentiated: Undifferentiated
    note_index_item_type:
      corporate_entity: Corporate Entity
      family: Family
      function: Function
      genre_form: Genre / Form
      geographic_name: Geographic Name
      name: Name
      occupation: Occupation
      person: Person
      subject: Subject
      title: Title
    note_rights_statement_act_type:
      additional_information: Additional Information
      expiration: Expiration
      extension: Extension
      permissions: Permissions
      restrictions: Restrictions
    note_rights_statement_type:
      additional_information: Additional Information
      materials: Materials
      type_note: Type Note
    _note_types:
      abstract: Abstract
      accessrestrict: Conditions Governing Access
      accruals: Accruals
      acqinfo: Immediate Source of Acquisition
      altformavail: Existence and Location of Copies
      appraisal: Appraisal
      arrangement: Arrangement
      bibliography: Bibliography
      bioghist: Biographical / Historical
      contact_note: Contact Note
      custodhist: Custodial History
      dimensions: Dimensions
      edition: Edition
      extent: Extent
      fileplan: File Plan
      general_context: General Context
      index: Index
      inscription: Inscription
      langmaterial: Language of Materials
      legal_status: Legal Status
      legalstatus: Legal Status
      mandate: Mandate
      materialspec: Materials Specific Details
      note: General Note
      note_bibliography: Bibliography
      odd: General
      originalsloc: Existence and Location of Originals
      otherfindaid: Other Finding Aids
      physdesc: Physical Description
      physfacet: Physical Facet
      physloc: Physical Location
      phystech: Physical Characteristics and Technical Requirements
      prefercite: Preferred Citation
      processinfo: Processing Information
      relatedmaterial: Related Materials
      rights_statement: Rights
      scopecontent: Scope and Contents
      separatedmaterial: Separated Materials
      structure_or_genealogy: Structure Or Genealogy
      summary: Summary
      userestrict: Conditions Governing Use
    note_digital_object_type:
      abstract: Abstract
      accessrestrict: Conditions Governing Access
      accruals: Accruals
      acqinfo: Immediate Source of Acquisition
      altformavail: Existence and Location of Copies
      appraisal: Appraisal
      arrangement: Arrangement
      bibliography: Bibliography
      bioghist: Biographical / Historical
      contact_note: Contact Note
      custodhist: Custodial History
      dimensions: Dimensions
      edition: Edition
      extent: Extent
      fileplan: File Plan
      general_context: General Context
      index: Index
      inscription: Inscription
      langmaterial: Language of Materials
      legal_status: Legal Status
      legalstatus: Legal Status
      mandate: Mandate
      materialspec: Materials Specific Details
      note: General Note
      note_bibliography: Bibliography
      odd: General
      originalsloc: Existence and Location of Originals
      otherfindaid: Other Finding Aids
      physdesc: Physical Description
      physfacet: Physical Facet
      physloc: Physical Location
      phystech: Physical Characteristics and Technical Requirements
      prefercite: Preferred Citation
      processinfo: Processing Information
      relatedmaterial: Related Materials
      rights_statement: Rights
      scopecontent: Scope and Contents
      separatedmaterial: Separated Materials
      structure_or_genealogy: Structure Or Genealogy
      summary: Summary
      userestrict: Conditions Governing Use
    note_langmaterial_type:
      abstract: Abstract
      accessrestrict: Conditions Governing Access
      accruals: Accruals
      acqinfo: Immediate Source of Acquisition
      altformavail: Existence and Location of Copies
      appraisal: Appraisal
      arrangement: Arrangement
      bibliography: Bibliography
      bioghist: Biographical / Historical
      contact_note: Contact Note
      custodhist: Custodial History
      dimensions: Dimensions
      edition: Edition
      extent: Extent
      fileplan: File Plan
      general_context: General Context
      index: Index
      inscription: Inscription
      langmaterial: Language of Materials
      legal_status: Legal Status
      legalstatus: Legal Status
      mandate: Mandate
      materialspec: Materials Specific Details
      note: General Note
      note_bibliography: Bibliography
      odd: General
      originalsloc: Existence and Location of Originals
      otherfindaid: Other Finding Aids
      physdesc: Physical Description
      physfacet: Physical Facet
      physloc: Physical Location
      phystech: Physical Characteristics and Technical Requirements
      prefercite: Preferred Citation
      processinfo: Processing Information
      relatedmaterial: Related Materials
      rights_statement: Rights
      scopecontent: Scope and Contents
      separatedmaterial: Separated Materials
      structure_or_genealogy: Structure Or Genealogy
      summary: Summary
      userestrict: Conditions Governing Use
    note_multipart_type:
      abstract: Abstract
      accessrestrict: Conditions Governing Access
      accruals: Accruals
      acqinfo: Immediate Source of Acquisition
      altformavail: Existence and Location of Copies
      appraisal: Appraisal
      arrangement: Arrangement
      bibliography: Bibliography
      bioghist: Biographical / Historical
      contact_note: Contact Note
      custodhist: Custodial History
      dimensions: Dimensions
      edition: Edition
      extent: Extent
      fileplan: File Plan
      general_context: General Context
      index: Index
      inscription: Inscription
      langmaterial: Language of Materials
      legal_status: Legal Status
      legalstatus: Legal Status
      mandate: Mandate
      materialspec: Materials Specific Details
      note: General Note
      note_bibliography: Bibliography
      odd: General
      originalsloc: Existence and Location of Originals
      otherfindaid: Other Finding Aids
      physdesc: Physical Description
      physfacet: Physical Facet
      physloc: Physical Location
      phystech: Physical Characteristics and Technical Requirements
      prefercite: Preferred Citation
      processinfo: Processing Information
      relatedmaterial: Related Materials
      rights_statement: Rights
      scopecontent: Scope and Contents
      separatedmaterial: Separated Materials
      structure_or_genealogy: Structure Or Genealogy
      summary: Summary
      userestrict: Conditions Governing Use
    note_singlepart_type:
      abstract: Abstract
      accessrestrict: Conditions Governing Access
      accruals: Accruals
      acqinfo: Immediate Source of Acquisition
      altformavail: Existence and Location of Copies
      appraisal: Appraisal
      arrangement: Arrangement
      bibliography: Bibliography
      bioghist: Biographical / Historical
      contact_note: Contact Note
      custodhist: Custodial History
      dimensions: Dimensions
      edition: Edition
      extent: Extent
      fileplan: File Plan
      general_context: General Context
      index: Index
      inscription: Inscription
      langmaterial: Language of Materials
      legal_status: Legal Status
      legalstatus: Legal Status
      mandate: Mandate
      materialspec: Materials Specific Details
      note: General Note
      note_bibliography: Bibliography
      odd: General
      originalsloc: Existence and Location of Originals
      otherfindaid: Other Finding Aids
      physdesc: Physical Description
      physfacet: Physical Facet
      physloc: Physical Location
      phystech: Physical Characteristics and Technical Requirements
      prefercite: Preferred Citation
      processinfo: Processing Information
      relatedmaterial: Related Materials
      rights_statement: Rights
      scopecontent: Scope and Contents
      separatedmaterial: Separated Materials
      structure_or_genealogy: Structure Or Genealogy
      summary: Summary
      userestrict: Conditions Governing Use
    place_role:
      assoc_country: Associated Country
      other_assoc: Other
      place_of_birth: Place of Birth
      place_of_death: Place of Death
      residence: Residence
    publication_status:
      approved: Approved
      in_process: In-process
    reference_evaluation:
      natc: No attempt to code
      not_applicable: Not applicable
      tr_consistent: Tracings consistent with headings
      tr_inconsistent: Tracings inconsistent with headings
    resource_finding_aid_description_rules:
      aacr: AACR
      cco: CCO
      dacs: DACS
      isadg: ISADG
      rad: RAD
    resource_finding_aid_status:
      completed: Completed
      in_progress: In Progress
      under_revision: Under Revision
      unprocessed: Unprocessed
      not_needed: Not Needed
    resource_resource_type:
      collection: Collection
      papers: Papers
      publications: Publications
      records: Records
    restriction_type:
      ColdStorageBrbl: 5 - Other
      InProcessSpecColl: 4 - Restricted in-process
      RestrictedCurApprSpecColl: 2 - Repository imposed access restriction
      RestrictedFragileSpecColl: 3 - Restricted fragile
      RestrictedSpecColl: 1 - Donor/university imposed access restriction
    rights_statement_act_restriction:
      allow: Allow
      conditional: Conditional
      disallow: Disallow
    rights_statement_act_type:
      delete: Delete
      disseminate: Disseminate
      migrate: Migrate
      modify: Modify
      replicate: Replicate
      use: Use
    rights_statement_external_document_identifier_type:
      agrovoc: 'AGROVOC multilingual agricultural thesaurus. (Rome: APIMONDIA)'
      allmovie: AllMovie
      allmusic: AllMusic
      allocine: AlloCiné
      amnbo: American National Biography Online
      ansi: American National Standards Institute and National Information Standards
        Organisation number for an ANSI or ANSI/NISO standard
      artsy: Artsy
      bdusc: Biographical Directory of the United States Congress (United States Congress)
      bfi: BFI - British Film Institute
      bnfcg: 'BnF catalogue général (Paris: Bibliothèque nationale de France)'
      cantic: CANTIC (Catàleg d'autoritats de noms i títols de Catalunya) (Biblioteca
        de Catalunya)
      cgndb: Canadian Geographical Names Database (Natural Resources Canada)
      danacode: 'Danacode (Bnei Brak, Israel: D.A.N.A. Systems)'
      datoses: datos.bne.es (Biblioteca Nacional de España)
      discogs: Discogs
      dkfilm: Det Danske Filminstitut Filmdatabasen
      doi: Digital Object Identifier
      ean: International Article Number
      eidr: 'EIDR: Entertainment Identifier Registry'
      fast: 'Faceted Application of Subject Terminology (Dublin, Ohio: OCLC)'
      filmport: filmportal.de
      findagr: Find a Grave
      freebase: Freebase
      gec: Gran enciclopèdia catalana
      geogndb: Geographic Names Database
      geonames: GeoNames
      gettytgn: Getty Thesaurus of Geographic Names Online (J. Paul Getty Trust)
      gettyulan: Union List of Artist Names Online (J. Paul Getty Trust)
      gnd: 'Gemeinsame Normdatei (Leipzig, Frankfurt: Deutsche Nationalbibliothek)'
      gnis: Geographic Names Information System (GNIS) (United States Geological Survey,
        Board on Geographic Names)
      gtin-14: Global Trade Identification Number 14 (EAN/UCC-128 or ITF-14)
      hdl: Handle
      ibdb: IBDB - Internet Broadway Database
      idref: 'IdRef: le referentiel des autorites Sudoc (L''agence bibliographique
        de l''enseignement superieur (ABES))'
      imdb: IMDb - Internet Movie Database
      isan: International Standard Audiovisual Number
      isbn: International Standard Book Number
      isbn-a: International Standard Book Number (the actionable ISBN) (International
        DOI Foundation (IDF))
      isbnre: ISBN (International Standard Book Number) registrant element
      isil: ISIL (International Standard Identifier for Libraries and Related Organizations)
      ismn: International Standard Music Number
      isni: International Standard Name Identifier
      iso: International Organization for Standardization number for an ISO standard
      isrc: International Standard Recording Code
      issn: International Standard Serial Number
      issn-l: Linking International Standard Serial Number
      issue-number: Sound recording issue number
      istc: International Standard Text Code
      iswc: International Standard Musical Work Code
      itar: ITAR (Importtjeneste og autoritetsregistre)
      kinopo: КиноПоиск = KinoPoisk
      lccn: Library of Congress Control Number
      lcmd: 'Library of Congress Manuscript Division (Washington, DC: Library of Congress)'
      lcmpt: 'Library of Congress Medium of Performance Thesaurus for Music (LCMPT)
        (Washington, DC: Library of Congress)'
      libaus: Libraries Australia (National Library of Australia)
      local: Locally defined identifier
      matrix-number: Sound recording matrix number
      moma: 'Museum of Modern Art (New York: Museum of Modern Art)'
      munzing: Munzinger (Munzinger Archiv)
      music-plate: Publisher's music plate number
      music-publisher: Publisher-assigned music number
      musicb: MusicBrainz
      natgazfid: U.S. National Gazetteer Feature Name Identifier
      nga: 'National Gallery of Art (Washington DC: National Gallery of Art)'
      nipo: Número de Identificación de las Publicaciones Oficiales
      nndb: NNDB (Notable Names Database)
      npg: 'National Portrait Gallery (London: National Portrait Gallery)'
      odnb: Oxford Dictionary of National Biography (Oxford University Press)
      opensm: OpenStreetMap
      orcid: Open Researcher and Contributor IDentifier
      oxforddnb: Oxford Biography Index
      porthu: PORT.hu
      rbmsbt: 'RBMS Controlled Vocabularies: Binding Terms (Rare Books and Manuscripts
        Section, Association of College & Research Libraries)'
      rbmsgt: 'RBMS Controlled Vocabularies: Genre Terms (Rare Books and Manuscripts
        Section, Association of College & Research Libraries)'
      rbmspe: 'RBMS Controlled Vocabularies: Provenance Evidence (Rare Books and Manuscripts
        Section, Association of College & Research Libraries)'
      rbmsppe: 'RBMS Controlled Vocabularies: Printing and Publishing Evidence (Rare
        Books and Manuscripts Section, Association of College & Research Libraries)'
      rbmspt: 'RBMS Controlled Vocabularies: Paper Terms (Rare Books and Manuscripts
        Section Association of College & Research Libraries)'
      rbmsrd: 'RBMS Controlled Vocabularies: Relationship Designators (Rare Books
        and Manuscripts Section, Association of College & Research Libraries)'
      rbmste: 'RBMS Controlled Vocabularies: Type Evidence (Rare Books and Manuscripts
        Section, Association of College & Research Libraries)'
      rid: ResearcherID (Thomson Reuters)
      rkda: 'RKDartists& (Den Haag: Rijksbureau voor Kunsthistorische Documentatie)'
      saam: 'Smithsonian American Art Museum (Washington DC: Smithsonian Institution)'
      scholaru: Scholar Universe
      scope: Scope
      scopus: Scopus Author Identifier
      sici: Serial Item and Contribution Identifier
      spotify: Spotify
      sprfbsb: 'Sports Reference: Baseball'
      sprfbsk: 'Sports Reference: Basketball'
      sprfcbb: 'Sports Reference: College Basketball'
      sprfcfb: 'Sports Reference: College Football'
      sprfhoc: 'Sports Reference: Hockey'
      sprfoly: 'Sports Reference: Olympic Sports'
      sprfpfb: 'Sports Reference: Pro Football'
      stock-number: Publisher, distributor, or vendor stock number
      strn: Standard Technical Report Number
      svfilm: Svensk Filmdatabas
      tatearid: Tate Artist Identifier
      theatr: Theatricalia
      trove: Trove (National Library of Australia)
      upc: Universal Product Code
      uri: Uniform Resource Identifier
      urn: Uniform Resource Name
      viaf: Virtual International Authority File number
      videorecording-identifier: Publisher-assigned videorecording number
      wikidata: Wikidata (Wikimedia Foundation)
      wndla: 'Web NDL Authorities (Tokyo: National Diet Library (NDL))'
    rights_statement_ip_status:
      copyrighted: Copyrighted
      public_domain: Public Domain
      unknown: Unknown
    rights_statement_other_rights_basis:
      donor: Donor
      policy: Policy
    rights_statement_rights_type:
      copyright: Copyright
      license: License
      other: Other
      statute: Statute
    romanization:
      conv_rom_cat_agency: Conventional romanization or conventional form of name
        in language of cataloging agency
      int_std: International standard
      local_standard: Local standard
      nat_std: National standard
      nl_assoc_std: National library association standard
      nl_bib_agency_std: National library or bibliographic agency standard
      not_applicable: Not applicable
      unknown_standard: Standard of unknown origin
    script_iso15924:
      Adlm: Adlam
      Afak: Afaka
      Aghb: Caucasian Albanian
      Ahom: Ahom, Tai Ahom
      Arab: Arabic
      Aran: Arabic (Nastaliq variant)
      Armi: Imperial Aramaic
      Armn: Armenian
      Avst: Avestan
      Bali: Balinese
      Bamu: Bamum
      Bass: Bassa Vah
      Batk: Batak
      Beng: Bengali (Bangla)
      Bhks: Bhaiksuki
      Blis: Blissymbols
      Bopo: Bopomofo
      Brah: Brahmi
      Brai: Braille
      Bugi: Buginese
      Buhd: Buhid
      Cakm: Chakma
      Cans: Unified Canadian Aboriginal Syllabics
      Cari: Carian
      Cham: Cham
      Cher: Cherokee
      Cirt: Cirth
      Copt: Coptic
      Cpmn: Cypro-Minoan
      Cprt: Cypriot syllabary
      Cyrl: Cyrillic
      Cyrs: Cyrillic (Old Church Slavonic variant)
      Deva: Devanagari (Nagari)
      Dogr: Dogra
      Dsrt: Deseret (Mormon)
      Dupl: Duployan shorthand, Duployan stenography
      Egyd: Egyptian demotic
      Egyh: Egyptian hieratic
      Egyp: Egyptian hieroglyphs
      Elba: Elbasan
      Elym: Elymaic
      Ethi: Ethiopic (Geʻez)
      Geok: Khutsuri (Asomtavruli and Nuskhuri)
      Geor: Georgian (Mkhedruli and Mtavruli)
      Glag: Glagolitic
      Gong: Gunjala Gondi
      Gonm: Masaram Gondi
      Goth: Gothic
      Gran: Grantha
      Grek: Greek
      Gujr: Gujarati
      Guru: Gurmukhi
      Hanb: Han with Bopomofo (alias for Han + Bopomofo)
      Hang: Hangul (Hangŭl, Hangeul)
      Hani: Han (Hanzi, Kanji, Hanja)
      Hano: Hanunoo (Hanunóo)
      Hans: Han (Simplified variant)
      Hant: Han (Traditional variant)
      Hatr: Hatran
      Hebr: Hebrew
      Hira: Hiragana
      Hluw: Anatolian Hieroglyphs (Luwian Hieroglyphs, Hittite Hieroglyphs)
      Hmng: Pahawh Hmong
      Hmnp: Nyiakeng Puachue Hmong
      Hrkt: Japanese syllabaries (alias for Hiragana + Katakana)
      Hung: Old Hungarian (Hungarian Runic)
      Inds: Indus (Harappan)
      Ital: Old Italic (Etruscan, Oscan, etc.)
      Jamo: Jamo (alias for Jamo subset of Hangul)
      Java: Javanese
      Jpan: Japanese (alias for Han + Hiragana + Katakana)
      Jurc: Jurchen
      Kali: Kayah Li
      Kana: Katakana
      Khar: Kharoshthi
      Khmr: Khmer
      Khoj: Khojki
      Kitl: Khitan large script
      Kits: Khitan small script
      Knda: Kannada
      Kore: Korean (alias for Hangul + Han)
      Kpel: Kpelle
      Kthi: Kaithi
      Lana: Tai Tham (Lanna)
      Laoo: Lao
      Latf: Latin (Fraktur variant)
      Latg: Latin (Gaelic variant)
      Latn: Latin
      Leke: Leke
      Lepc: Lepcha (Róng)
      Limb: Limbu
      Lina: Linear A
      Linb: Linear B
      Lisu: Lisu (Fraser)
      Loma: Loma
      Lyci: Lycian
      Lydi: Lydian
      Mahj: Mahajani
      Maka: Makasar
      Mand: Mandaic, Mandaean
      Mani: Manichaean
      Marc: Marchen
      Maya: Mayan hieroglyphs
      Medf: Medefaidrin (Oberi Okaime, Oberi Ɔkaimɛ)
      Mend: Mende Kikakui
      Merc: Meroitic Cursive
      Mero: Meroitic Hieroglyphs
      Mlym: Malayalam
      Modi: Modi, Moḍī
      Mong: Mongolian
      Moon: Moon (Moon code, Moon script, Moon type)
      Mroo: Mro, Mru
      Mtei: Meitei Mayek (Meithei, Meetei)
      Mult: Multani
      Mymr: Myanmar (Burmese)
      Nand: Nandinagari
      Narb: Old North Arabian (Ancient North Arabian)
      Nbat: Nabataean
      Newa: Newa, Newar, Newari, Nepāla lipi
      Nkdb: Naxi Dongba (na²¹ɕi³³ to³³ba²¹, Nakhi Tomba)
      Nkgb: Naxi Geba (na²¹ɕi³³ gʌ²¹ba²¹, 'Na-'Khi ²Ggŏ-¹baw, Nakhi Geba)
      Nkoo: N’Ko
      Nshu: Nüshu
      Ogam: Ogham
      Olck: Ol Chiki (Ol Cemet’, Ol, Santali)
      Orkh: Old Turkic, Orkhon Runic
      Orya: Oriya (Odia)
      Osge: Osage
      Osma: Osmanya
      Palm: Palmyrene
      Pauc: Pau Cin Hau
      Perm: Old Permic
      Phag: Phags-pa
      Phli: Inscriptional Pahlavi
      Phlp: Psalter Pahlavi
      Phlv: Book Pahlavi
      Phnx: Phoenician
      Piqd: Klingon (KLI pIqaD)
      Plrd: Miao (Pollard)
      Prti: Inscriptional Parthian
      Qaaa: Reserved for private use (start)
      Qabx: Reserved for private use (end)
      Rjng: Rejang (Redjang, Kaganga)
      Rohg: Hanifi Rohingya
      Roro: Rongorongo
      Runr: Runic
      Samr: Samaritan
      Sara: Sarati
      Sarb: Old South Arabian
      Saur: Saurashtra
      Sgnw: SignWriting
      Shaw: Shavian (Shaw)
      Shrd: Sharada, Śāradā
      Shui: Shuishu
      Sidd: Siddham, Siddhaṃ, Siddhamātṛkā
      Sind: Khudawadi, Sindhi
      Sinh: Sinhala
      Sogd: Sogdian
      Sogo: Old Sogdian
      Sora: Sora Sompeng
      Soyo: Soyombo
      Sund: Sundanese
      Sylo: Syloti Nagri
      Syrc: Syriac
      Syre: Syriac (Estrangelo variant)
      Syrj: Syriac (Western variant)
      Syrn: Syriac (Eastern variant)
      Tagb: Tagbanwa
      Takr: Takri, Ṭākrī, Ṭāṅkrī
      Tale: Tai Le
      Talu: New Tai Lue
      Taml: Tamil
      Tang: Tangut
      Tavt: Tai Viet
      Telu: Telugu
      Teng: Tengwar
      Tfng: Tifinagh (Berber)
      Tglg: Tagalog (Baybayin, Alibata)
      Thaa: Thaana
      Thai: Thai
      Tibt: Tibetan
      Tirh: Tirhuta
      Ugar: Ugaritic
      Vaii: Vai
      Visp: Visible Speech
      Wara: Warang Citi (Varang Kshiti)
      Wcho: Wancho
      Wole: Woleai
      Xpeo: Old Persian
      Xsux: Cuneiform, Sumero-Akkadian
      Yiii: Yi
      Zanb: Zanabazar Square (Zanabazarin Dörböljin Useg, Xewtee Dörböljin Bicig,
        Horizontal Square Script)
      Zinh: Code for inherited script
      Zmth: Mathematical notation
      Zsye: Symbols (Emoji variant)
      Zsym: Symbols
      Zxxx: Code for unwritten documents
      Zyyy: Code for undetermined script
      Zzzz: Code for uncoded script
    source:
      local: Local
      naf: NAF
      snac: SNAC
    subject_source:
      aat: AAT
      cash: CASH
      gmgpc: GMGPC
      ingest: Unspecified ingested source
      lcgft: LCGFT
      lcsh: LCSH
      lcshac: LCSHAC
      local: Local sources
      mesh: MESH
      nal: NAL
      ram: RAM
      rbgenr: RBRGENR
      rvm: RVM
      tgn: TGN
    subject_term_type:
      cultural_context: Cultural context
      function: Function
      genre_form: Genre / Form
      geographic: Geographic
      occupation: Occupation
      style_period: Style / Period
      technique: Technique
      temporal: Temporal
      topical: Topical
      uniform_title: Uniform Title
    transliteration:
      ala-lc: ALA-LC Romanization Tables
    user_defined_enum_1:
      novalue: No value defined
    user_defined_enum_2:
      novalue: No value defined
    user_defined_enum_3:
      novalue: No value defined
    user_defined_enum_4:
      novalue: No value defined
